#####################
#S          #   #   #
# ### ##### ### # # #
#   #   # # # # # # #
# ### ### ### # ### #
# # #     # #       #
### ### ### ####### #
#           #   # # #
# ### ### # # ### # #
# #   #   #     # # #
### ### ### # ### # #
#   # #   # # #     #
# ### ### # # # ### #
#   #     # #   #   #
####### ####### ### #
# # #       #   # # #
# # ######### # # ###
#   # # #   # # # # #
### # # ### # ### # #
#                  E#
#####################
