#####################################################################################################
#S      #     #   #     #           #     # # # #           #     #           #   # #     #     #   #
# ### ### # ### # ### ##### ####### ### ### # # # ### ##### ##### ######### # # # # # ### # ### ### #
#   #   # #     # # # # #     #     #   #       #   # #           #   #   # # # # #   #     #   #   #
####### ##### # ### # # ##### # # ##### # ### ##### ##### ########### ### ### ### # ####### ### # ###
#   #   #     #     #   #   # # # # #   #   # # # #   #   #   #   #   #   #           #   # #   # # #
### # # # ####### ### # ### # ### # # # # ##### # # # ####### ### # # # # ######### # ### ####### # #
#     #   #   #       #   # #   #     # # # # # #   # #       # #   # # #   #     # #       # #     #
### ### ##### ### ##### ### # # # # # # # # # # ##### ### ##### ### # # ### # # # ### # ##### # #####
#   #   # # #   # #   # # #   # # # # #     #           # #         # # #   # # # #   #   #     #   #
# ####### # ### # # ##### ### ##### # # # ### ####### # # ### ######### ### # ######### ### ### ### #
# #   #       # # #     #     #   # # # # #   #   #   #       #   # #     #   #     # #   # # # #   #
# # ### ### ### # # # # ##### ### # ##### ### # ### ##### ### ### # ### ##### ### ### ### # # # # ###
# #     # # #       # # # #   #     #   # #     # #   #     #         # #                   #       #
####### # # ####### ### # ##### ### # ### ### ### # # ##### ########### ##### # # ##### # ######### #
# #   # #     #   # # # #   # # #       # #     #   # # # # #           #   # # #   #   # #   # #   #
# ### ### # ### # # # ##### # ####### # ####### # # ### # ### ########### # # # # ### # # # # # ### #
# #     # #     #       #     #   #   #     #   # #                   #   # # # # #   # #   #   #   #
# # # ####### ####### ### # ### ##### ######### ##### ##### ######### ##### ##### ####### ####### ###
#   #       #   #         #   #           #     #   # #     #             #             # # # #     #
# ######### # ### ### ##### ####### ### ### # # # ### ### ##### # ### # ##### # ### ##### # # ##### #
# #   #   #     #   # #   #   # #   #       # # #     #   # #   #   # #   # # #   # # #     #     # #
# # ##### # # # # ####### # ### ### ### ####### ##### # ### ### ########### # # ##### # # ### ### # #
# # #   #   # # # #   #   #       # #     # #   #     # #   # # #     #   #   #   #   # # #     #   #
# # ### # ####### ### ### ### ##### ##### # ######### ### ### ### ##### ######### # ####### ####### #
# #         #     # # #         # #     #       #                   #   #   # #       # #     #     #
# ### ##### ### ### # ##### ##### ### ### ### # # ######### # # # ### ### # # ### ##### ### ### # # #
# #       # #   #     # #     #     # #     # # #   #   #   # # # #       # #   # #     # #   # # # #
### # ######### ### ### # # ##### # # ######### # ### # # ##### ### ##### # ### ### ##### # ####### #
#   #         #       #   # #   # #   #     #   # #   # # # # #   #     # #     #       #     #     #
### ################# ### # ### # ### # ### ##### # # ##### # # ####### # # ##### ####### ######### #
#   #       #       #   # #   #     #   #   #   #   # #       #     # # # #     #     #   # # #   # #
# ######### ### ### ####### # # ############# # # # ##### ##### # ### ##### ##### # ### ### # ### # #
# # #         # #   #     # # # #       # # # # # # #         # #       #   # # # #   #     #     # #
# # # ### ##### ##### ##### # # # ####### # # ########### # ######### ##### # # ##### ##### # # # # #
#   # #   #   # #       #   #   #               #   #     #   #   #         # #   #   # # # # # #   #
######### # # # ##### # ### ####### # ### ####### ####### # # # ##### ##### # ### ### # # ### ##### #
#       #   #   #     #   # # #     #   # #       # #     # #       # # # #   #   #             # # #
# # ### # # # # ### ######### # ##### ### ##### # # # # ### ######### # # # ### ##### ####### ### # #
# #   #   # # #   #   #     # #     # # #   #   #   # # #         #   #         #         #   # # # #
### # ### ######### ### # ### # ##### # # ### ### ####### ########### ##### # ##### ### ####### # ###
#   #   #           #   #   # #     # # #   # #   #   #       #         # # #     # #         # #   #
### # # ### # ### ### ####### ##### ### ### ##### ### # ##### ##### # # # ####### ####### # # # # # #
#   # # #   # #   # # #   #   #           #   #         #         # # #         # # # #   # #     # #
### ##### ####### # # ### # # ##### ##### ####### ### ### # ##### # ##### # ### ### # ####### # #####
# # #   #     #   #   #   # #   # # #     #   #     #   # # #     #     # # #   # # # # # # # # #   #
# ### # ####### # # ### # # # ### ##### ##### ### ########### # ### ####### # ### # # # # # ### # ###
#   # # # # #   #   # # #   # #         #   # #   # #         # #   # #   # # #           #         #
# ##### # # ### ##### ### ####### ### ### # # ##### ######### # # ### # ### # ### # ######### ### # #
#   #   # #         #   #   #     #   # # #       #     # # # #   #         # # # #         # #   # #
# # # ### ##### # ### # ### ######### # ### # ##### ##### # ##### # ##### # ### ### ##### ### ### # #
# #   #   #     # #   #         #   #   #   #     #               #     # #     # # #     #     # # #
##### ### ##### ##### ### ######### # ########### # # ### # # ### ####### ##### # ##### # ### #######
# #     #   #       # # # #     #       # #       # #   # # # #     #     # #   #   # # #   # # # # #
# ##### # ####### ### # ####### ### ### # # # # ########### ### ##### # ### ####### # ### ### # # # #
# #   #     # #   # #   #   # # #     #   # # # #       # #   #   # # #   #     #     #     #   # # #
# ### ### ### ### # ### ### # # ####### ### # # ##### # # ######### # ### # ### ##### ### ####### # #
# #       #     # #       #     #     #   # # # #     #   #   # #     #     # #         # # #   # # #
# ####### ### ### # # ######### # # ##### ##### ### # ##### ### # ########### ### ### ### # # # # # #
#   #   #         # #     #     # #   #         #   #         # # #           #     #   # #   # #   #
# ### ####### ### # ##### ##### ##### ##### ### ####### # ##### ### ### # # # # ####### # # # # # # #
#           # #     # #     #       #   # # #       # # # #   #     # # # # #   # #         # #   # #
########### # # # # # # ####### # # # ### ### ####### # ### ######### ### ### # # ##### ##### # #####
#       #   # # # # # #       # # # #           #   #     #   # #     # #   # # # #   #   # # # #   #
####### # # # ### # # ### ####### ### ##### ####### ##### # ### ##### # # ### ### # # ### # ### ### #
#         #     # #   # #   #     # # #         #       # #       #   #   # #     # # # #     #     #
# ####### ############# ### # # # # ### ####### ### # # # ### ####### ##### # ### # ### ####### ### #
#   #                   # # # # # # #     #         # # # #         # #       #     #   #   #     # #
### # ##### ##### # ### # # # ##### # ### # # # ######### # ######### ############# ### ### ### # ###
#   #   #     # # # #   #   #       # #   # # #   # #         #     #       #       # #         #   #
# ####### ##### # ### ##### # ################# ### ####### ##### ##### # ### ### ### ### # ####### #
# # #   #     # # #     #     #           #   #       #         #   # # #     #     # #   # #   #   #
# # ### ### ### ##### # ### # ##### ### # # ### # ### # ####### # ### # # # # ####### ### ### ##### #
# #   #     #   #   # # #   #     # #   # #   # #   #     # #     #     # # #     # #       # # # # #
# # ####### # # ### ######### # ### ### ##### ##### ####### ##### ######### # ### # # # # # # # # # #
# # # #       # #         #   # #   #       #           #   # #             # #   #   # # # #   #   #
# # # # # ### ########### # # ####### ##### ### ### ####### # ####### ####### # # ### ##### ### # ###
# #     #   #   # #         #         #   #   # #   #       #   # #   #       # # #   #   # #       #
# ##### ### # # # # ################# # ######### ### ####### ### # ############# ####### ### ##### #
# #   # #   # # # #   # # #     #         # #     # #   #     # #   #       # #           # #   # # #
# # ####### ##### # ### # # ### # ######### # ##### ### ### ### ##### ### ### ### ####### # # ### # #
#         #       #       # # # #   #     #   #   #   # #         # # #   #     #   #   # #   # #   #
### # # # ### ##### ##### # # ### ### ####### # # ### # # # ####### ### ##### ### # # ######### # # #
#   # # #   #     # #     #               #     #   #   # #   # #   #         #   #         #     # #
# ##### ##### # ####### ### # ####### ### ### ### ##### ##### # ### ##### ##### # ############# #####
#   #   #     # # # #   # # # # #       # #   # #     #     #   #       #   #   #     #       #     #
# ########### # # # ##### ### # ######### # # # ### # # ####### ##### # ### ### ####### # ####### # #
# #     # #   #   # #     #   #       # # # # # #   #   # #           #   #       #     #         # #
# ##### # ####### # ##### ######### # # ### # # # ####### # # ######### # ######### ##### ##### # ###
#   # #   #   # #               #   #   #   #   #         # # # # #     #   #   #   #         # #   #
# ### ### # ### ### ####### ### ##### ### # # ### # # ##### # # # ### ### # # # ### ####### #########
# # #     #             #   #           # # # # # # #     # #   # #     # #   # # # #   #           #
# # # ### # ####### ### ### # ##### ##### ##### # ### ######### # # ####### ### # ##### # ### #######
# # # # # # #     #   # #   # # # # #     #   #     #     # # # #     #       # # # # # #   # #     #
### # # # # # ##### ####### ### # ### ### # ##### # ### ### # ##### ######### # # # # # ### ### #####
#   #   #   #   # #   # # #   #     # # #   # #   #   # #   # #     # # #     # # #     #           #
### # # # ### # # ##### # ### ### # # # # ### ### ####### ### ### # # # ##### # # # # # ##### #######
#     # # # # #     #       #   # #   # # #   # # #               # #   # #   # #   # #       #   # #
# # ### ### # ### ### ### # # # # ### # # ### # ######### ##### ### ### # ### ### # # # # ### # ### #
# #   #   #     #       # #   #     # #       #               #   #     #         # # # #   #      E#
#####################################################################################################
