###########
#S  #     #
# ##### ###
# #       #
# ### #####
#       # #
# ##### # #
# #   #   #
### #######
#        E#
###########
